--------------------------------------------------------------------------------------------------------------------------------------------------------------------------------------------------------
--------------------------------------------------------------------------------------------------------------------------------------------------------------------------------------------------------
--------------------------------------------------------------------------------------------------------------------------------------------------------------------------------------------------------
--------------------------------------------------------------------------------------------------------------------------------------------------------------------------------------------------------
-------------------------?---------------------------------------------------------------------------------------------------M--------------------------------------------------------------------------
--------------------------------------------------------------------------------------------------------------------------------------------------------------------------------------------------------
--o---------------------------------------------------------------------------------------------------------------------------------------------------M-----------------------------------?-------------
--------------------------------------------------------------------------------------------------------------------o--------------------------------------M-------------------------------------o----v-
--------------------------------------------------------------------------------------------------------------------------------------------------?---------------------------------------------------f-
-------------?--------------------------------------------------------------------------------------------------?----B---o--------------------------------o-------------------------------------------f-
----------------------------B-------------------------------------------------------------------------------------------------------------------------------------------------------------------------f-
-------------?---------------------------------------X----o--X--------------------------------------------------B--------------------------------------T-------------------------------------------B?Tf-
-----------------X--------------T--------------------XX-----XX----------------------------------------------------------------------T-T----------------|-------------------XX------------------------|f-
-----------------XX-------------|--------------------XXX---XXX----------------------------------------------------------------------|-|----------------|-------------------XXX-----------------------|f-
m----------------XXX---T--------|--------------------XXXX-XXXX--------------------------------------------E-----------------E-E-----|-|-E--E---E---E---|---E-----T---------XXXX----E-----------------|X-
XXXXXXXXXXXXXXXXXXXXXXX|XXXXXXXX|XXXXXXXXXXXXXXXXXXXXXXXXXXXXXXXXXXXXXXXXXXXXXXXXXXXXXXXXXXXXXXXXXXXXXXXXXXXXXXXXXXXXXXXXXXXXXXXXXXX|X|XXXXXXXXXXXXXXXX|XXXXXXXXX|--XXXXXXXXXXXXXXXXXXX-X--XXXXXXXXXX|XX
