--------------------------------------------------------------------------------------------------------------------------------------------------------------------------------------------------------
--------------------------------------------------------------------------------------------------------------------------------------------------------------------------------------------------------
--------------------------------------------------------------------------------------------------------------------------------------------------------------------------------------------------------
--------------------------------------------------------------------------------------------------------------------------------------------------------------------------------------------------------
-?------------------------------------------------------------------------o--------------------------------------------------------------------------------------------B-------------M------------------
--------------------------------------------------------------o-M---------------------------------------------------------------------------------------------------------------------------------------
--------------------------------B-------------------------------------------------------------------------------------------------------------------------------------M---------------------------------
-------------------------------------------------------------------------------------------------------------------------------------------------------------------------------------------------o----v-
---------------------------------------------------------------------------------------------------------------------------------------------------------------------B--------------------------------f-
----------------------------------------------------------------B-----------------------------------------XX------o-----------------------------------------------------------------------------------f-
------------------------------------------------------------------------------------------------------------------------------------------------------------------------------------------------------f-
------------------------------------------------X----------------------------------------X-------------------------------?----------------------------------------------------------------------------f-
-----------------------------T-----------------XX---------------------------------------XX------------------------------------------------------------------------------------------------------------f-
---------------X-------------|----T-----------XXX--------------------------------------XXX------T----------------X-------------------------------------------------T----------------------------------f-
m--------------XX--E----E----|----|----------XXXX-------------------------------E-----XXXX------|----------------XX-E------------------------------E----------T----|----------------------------------X-
X--XXXXXXXXXX--XXXXXXXXXXXXXX|XXXX|XXXXXXXXXXXXXXXXXXXXXXXXXXXXXXXXXXXXXXXXXXXXXXXXXXXXXXXXXXXXX|XXXXXXXXXXXXXXXXXXXXXXXXXXXXXXXXXXXXXXX---XXXXXXXXXXXXXXXXXXX|XXXX|XXXXXXXXXXXXXX--XXXXXXXXXXXXXXXX---X
