--------------------------------------------------------------------------------------------------------------------------------------------------------------------------------------------------------
--------------------------------------------------------------------------------------------------------------------------------------------------------------------------------------------------------
--------------------------------------------------------------------------------------------------------------------------------------------------------------------------------------------------------
--------------------------------------------------------------------------------------------------------------------------------------------------------------------------------------------------------
--------------------------------------------------------------------------------------------------------------------------------------------------------------------------------------------------------
--------------BBB-------------------------------M---------------------------------M-----------------B-------------------------------------------------------o----?--------------------------------------
-------M----------XXX-----------------------------------XX---------------------------------------------------------------------------------------------------B------------------------------------------
-----------------B-------------------------------------------------------------------------------?-------------------------------------XXXX-----------------------------------------------------------v-
-o----------------------------------------------------------------------------------------------------------------------------???---------------------------------------------------------------------f-
------------------------------------------------------------------------------------------------------------------------------------------------------------------------------------------------------f-
------------------B-----------------------------------------------------------------------------------------------------------------------------------------------------------------------------X-----f-
-------------------------------------------XXXXX-----------------------------------------------------X-------------------------------------------------------------------X---------------------XX-----f-
---------TT-----------------------------------------------------------------------------------------XX-------------------------------------------------------------------XX-------------------XXX-----f-
---------||--------T--------------------------BBBB------------------------T------------------------XXX-------------------------------------------------------------------XXX-----------------XXXX-----f-
m-------B||BBEE----|E-----------------------------------------------------|----X------------------XXXX-------------------------------------------E-----------------------XXXX---------------XXXXX-----X-
XXXXXXXXX||XXXXXXXX|XXXXXXXXXXXXXXXXXXXXXXXXXXXXXXXXXXXXXXXXXXXXXXXXXXXXXX|XXXXXXXXXXXXXXXXXXXXXXXXXXX-XXXXXXXXXXXXXXXXXXXXXXXXXXXXXXXXXXXXXXXXXXXX---XXXXXXXXXXXXXXXXXXXXXXXXXXXXXXXXXXXXXXXXXXXXXXXXXX
