--------------------------------------------------------------------------------------------------------------------------------------------------------------------------------------------------------
--------------------------------------------------------------------------------------------------------------------------------------------------------------------------------------------------------
--------------------------------------------------------------------------------------------------------------------------------------------------------------------------------------------------------
--------------------------------------------------------------------------------------------------------------------------------------------------------------------------------------------------------
--------?-----------------------------------------------------------------------------------------------------------------------------------------------------------------------------------------------
--------------B----------------------------------------------------------------------------------------------------------------------------------------o---------------------------B--------------------
-----------------------------------------------------o-------------------------------------------M--------------------------------------B---------------------------------------------------------------
--------------------------------------------------------------------------------------------?--XXX----------------------------------------------------------------------------------------------------v-
--------------------------------------------------------------------------------------------------------------------------------------------------------------------------------------------------B---f-
--------------XXX--------------------------------------------------------------------------------------------------------------------------------------------------------------------BBB--------------f-
-------X-------------------------------------------------o-----------------------------?-------------------------------------??????----------------------------------------------------------------M--f-
------XX------------------------------------------------------------------------------------------------B---------------------------------------------------------------------------------------------f-
-BBBBXXX-----------------------------------------------------------------------------------------o--------------------------X------------------T----------------------------X-------------------------f-
----XXXX--------------------------------------------------------------------------------------------------------------------XX-----------------|---------------------------XX-------------------------f-
m--XXXXX-------E---------E------------------------------------T---------E-----------E---------------------------------------XXX--T-----E-------|------------------E-------XXX-------E---T-------------X-
XXXXXXXX--XXXXXXXXXXXXXXXXXXXXXXXXXXXXX---XXXXXXXXXXX---XXXXXX|XXXXXXXXXXXXXXXXXXXXXXXXXXXX--XX-XX-XXXXXXXXXXXXXXXXXXXXXXXXXXXXXX|XXXXXXXXXXXXX|XXXXXXXXXXXXXXXXXXXXXXXXXXXXXXXXXXXXXXXX|XXXXXXXXXXXXX-X
