--------------------------------------------------------------------------------------------------------------------------------------------------------------------------------------------------------
--------------------------------------------------------------------------------------------------------------------------------------------------------------------------------------------------------
--------------------------------------------------------------------------------------------------------------------------------------------------------------------------------------------------------
--------------------------------------------------------------------------------------------------------------------------------------------------------------------------------------------------------
--------------------------------------------------------------------------------------------------------------------------------------------------------------------------------------------------------
-----------------------------------------------------------------------------------------------------------XXX------------------------------------------------------------------------------------------
-----?-----------------------------------------------------------------------------------------------------------------------------------------------------B-------------------------------------o------
------------------------------------------------------------------------------------------------------------------------------------------------------------------------------------------------------v-
------------------------------------------------------------------------------------------------------------------------------------------------------------------------------------------------------f-
-------------------------------B----------------------------------------------------------------------------------------------------------------------------------------------------------------------f-
-------------------X-------------------------------------------------------------------------------------------------------------------B-------------------------------------------------------B------f-
------------------XX-------------------------------------------------------------------------------------------------------------------------------------------------------------------------------T--f-
-----------------XXX----T----------------------------------------------------------------------------------------------------------------------------------------------------------X---------------|--f-
----------------XXXX---X|-------------------------------------------------------------------------------------------------------T-------------------------------------------T------XX--------------|--f-
m--------------XXXXX--XX|---------------------------------------------------------------------------------------------E--E------|------E------------------------------------|------XXX-T---E-------|--E-
XXXXXXXXXXXX--XXXXXXXXXX|XXXXXXXXXXXXXXXXXXXXXXXXXXXXXXXXXXXXXXXXXXXXXXXXXXXXXXXXXXXXXXXXXXXXXXXXXXXXXXXXXXXXXXXXXXXXXXXXXXXXXXX|XXXXXXXXXXXXXXXXXXXX--XXXXXXXXXXXXXXXXXXXXX|XXXXXXXXXX|XXXXXXXXX??|??XX
