--------------------------------------------------------------------------------------------------------------------------------------------------------------------------------------------------------
--------------------------------------------------------------------------------------------------------------------------------------------------------------------------------------------------------
--------------------------------------------------------------------------------------------------------------------------------------------------------------------------------------------------------
--------------------------------------------------------------------------------------------------------------------------------------------------------------------------------------------------------
--------------------------------------------------------------------------------------------------------------------------------------------------------------------------------------------------------
----------------------------------------------------------M---------------------------------------------------------------------------------------------------------------------------------------------
----------------------------------------------------------------------------o---------------------------------------------------------------------------------------------------------------------------
--------------------------------------------------------------?-------------------------------------------------------B--------------------B----------------------?-----------------------------------v-
------------------------------------------------------------------M-----------------------------------------------------------------------------------------------------------------------------------f-
---------------------------------------------------------------------------------------------------------------------------------------------------------------------------------------------B--------f-
-----------------------------B----------------?------------------------B---------------------------------------------------------------------------------B--------------------------X------------?----f-
------X-------------------BB------------o-------------------------o---B----------------------------------------------------------------------------------------------T---------o---XX-----------------f-
----oXX-----------------------------------X--------------------------------------------------------------------------------------------------------------------------|------------XXX-----------------f-
----XXXX-----------T---------------------XX--------------------------------------------------------------------------------------------------------------------------|-----------XXXX-----------------f-
m--XTXXXX-------E--|----------E---------XXX--E---E------E------E-------------------E------------------------------------------------------------E------E-------------|-----E----XXXXX-----------------X-
XXXX|XXXXXXXXXXXXXX|XXXXXXXXXX--XXXXXXXXXXXXXXXXXXXXXXXXXXXXXX---XXXXXXXXXXXXXXXXXXXXX-XXXXXXXXXXXXXXXXXXXXXXXXXXXXXXXXXXXXXXXXXXXXXXXXXXXXXXXXXXXXXXXXXXXXXXXXXXXXXX|XXXXXXXXXXXXXXXXXXXXX--XXXXXXXXXXX
