--------------------------------------------------------------------------------------------------------------------------------------------------------------------------------------------------------
--------------------------------------------------------------------------------------------------------------------------------------------------------------------------------------------------------
--------------------------------------------------------------------------------------------------------------------------------------------------------------------------------------------------------
--------------------------------------------------------------------------------------------------------------------------------------------------------------------------------------------------------
-----------------------------------------------o--o------------------------------------------------------------------------B----------------------------------------------------------------------------
--------------------o------------------------------------------------------------------------------------------------------------------------------------X------------------------------------------M---
--------------------------------------------------------------------------------------------------------------------------------------------------------------------------------------------------------
-----------------------------------------------------------------------------------------------------------------------------------------------------------------o------------------------------------M-
-----------------------------------------------------------------------------------------------------------------------------------------------------------------BBBB---------------------------------f-
---------------------------------------------------------------------------------------------------XX---------------------M---------------------------------------------------------------------------f-
---------------------------X--------------------------------------------------------------------------------------------------------------------------------------------------------------------------f-
-------B------------------XX----------------M--------------------------B--------------------------------T----------------------------------------------------------M----B-----------------------------f-
---------X---------------XXX-------------------------------------------------------------X--------------|-------------------------------------------------------------------------------------------T-f-
--------XX--------------XXXX---------------------------X---------------------------------XX-------------|-------------------------------------------------------------------------------------------|-f-
m-----TXXX-------------XXXXX--------------------------XX---------------------------------XXX--X---------|--------------------------------------------E--E-------------------------------------------|-E-
XXXXXX|XXXXXXXXXXXXX-XXXXXXXXXXXXXXXXXXXXXXXXXXXXXXXXXXXXXXXXXXXXXXXXXXXXXXXXXXXXXXXXXXXXXXXXXXXXXXXXXXX|XXXXXXXXXX-XXXXXXXXXX---XXXXXXXXXXXXXXXXXXXXXXXXXXXXXXXXXXXXXXXXXXXXXXXXXXXXXXXXXXXXX--XXXX|XXX
