--------------------------------------------------------------------------------------------------------------------------------------------------------------------------------------------------------
--------------------------------------------------------------------------------------------------------------------------------------------------------------------------------------------------------
--------------------------------------------------------------------------------------------------------------------------------------------------------------------------------------------------------
----------------????------------------------------------------------------------------------------------------------------------------------------------------------------------------------------------
-------------------------o------------------------------------------------------------------------------------------------------------------------------------------------------------------------------
-------o----------------------------------------------------------------------------------------------------------------------------------------------------------------------------B-------------------
-------------M-----------------------------------------------------------------------------------------------------------------------M-------------------------o--o------------------------B--------M---
------------o----------------------------------------------------------------------------------------------------------------------------------------------------------------------BBBB---------------v-
--------------------------------------------------------------o--------------------------------------------------------------------------------------------------XX-----------------------------------f-
----------------------------------------????-------------------------------------------------------------------------------------------------------------------------------------------------B--------f-
---------XXXXXX-------------------------------------------------------------------------------------------------------------------X----------------------------------M------------B------------o----B-f-
----------------------B----------------------------------------------------------------------------------------------------------XX----------------------------T--------------------------------------f-
--------T-----------------------------------------------------------------------------------------------------------------------XXX----------------------------|---------XT-----------X---------------f-
--------|----------------------------------------------------------------------------------------------------------------------XXXX----------------------????--|---------X|----------XX---------------f-
m-------|--BEBBBB------E------------------------E-----------------------------------------------------------------------------XXXXX----------------------------|--E------X|X--------XXX-------------E-X-
XXXXXXXX|XXXXXXXXXXX-XXXXXXXXXXXXXX-XXX--XXXXXXXXXXXXXXXXXXXXXXXXXXXXXXXXXXXXXXXXXXXXXXXXXXXXXXXXXXXXXXXXXX--XXXXXXXXXXXXXXXXXXXXXXXXXXXXXXXXXXXXXXXXXXXXXXXXXX|XXXXX???XX|XX-XXXXXXXXXXXXXXXXXXXX---XXX
