--------------------------------------------------------------------------------------------------------------------------------------------------------------------------------------------------------
--------------------------------------------------------------------------------------------------------------------------------------------------------------------------------------------------------
--------------------------------------------------------------------------------------------------------------------------------------------------------------------------------------------------------
--------------------------------------------------------------------------------------------------------------------------------------------------------------------------------------------------------
----------o-----------------------------------------------------------------------------------------------------------------------------------------------------------------------------------------o---
-------o-???--------------------------------------------------------------------------------------------------------------------------------------------------------------------------------------------
------------------------------------------------------------------------------------------------------------------------------B-----------------o---------------------------?---------------------------
----------------------------o--------------------------------------------------------------------------------------------------------------------------------------------B----------------------------v-
----------------------------------------------B-B--------------------------------------------------------------------------------------------------M--------------------------------------------------f-
----------------------------------------------------------------------------------------------------------------XXXXX----------------------M----------------------------------------------------------f-
-------------------o----------?--------------------------------------------------------------------------------------------------------------B----o-----------------------------------B---------------f-
-------------------------o---------------------------------------------------------------------------------------------------------------------------------------------------------------B------------M-
------T-----------------------------------------------------------------------------------------------------------------------------------------------------------------------------------------------f-
------|--------------------------X-------------------T------------------------------------------------------------------T------------------T-----------------------------------------------------X----f-
m-----|--------EE-E-------------XX-------------------|------------------------------------------------------------------|----E-----EE------|---------------E------------------------------------XX----X-
XXX---|-XXXXXXXXXXXX---XXXXXXXXXXXXXXXXXXXXXXXXXXXXXX|XXXXXXXXXXXXXXXXXXXXXXXXXXXXXXXXXXXXXXXXXXXXXXXXXXXXXXXXXXXXXXXXXX|XXXXXXXXXXXXXXXXXX|XXXXXXXXXXXXXXXXXXXX---XXX-XXXXXXXXXXXXXXXXXXXXXXXXXXXXXXXXX
