--------------------------------------------------------------------------------------------------------------------------------------------------------------------------------------------------------
--------------------------------------------------------------------------------------------------------------------------------------------------------------------------------------------------------
--------------------------------------------------------------------------------------------------------------------------------------------------------------------------------------------------------
-----------------------------------------------------------------------------------------?????----------------------------------------------------------------------------------------------------------
----------------------------------------------------------------------------------o---------------------------------------------------------------------------------------------------------------------
--------------------------------------------------------------------------------------------------------------------------------------------------------------------------------------------------------
--------------------------------------------------------------o--------------------------------------------------?--------B-----------------------------------------------------------------------------
---------------------------------------???---------------------------------------M--------------------------------------------------------------------------------------------------------------------v-
-------------------------------------------------------------------------------------------------------------------XXXX-------------------------------------------?-----------------------------------f-
-------------------------------------B------------------------------------------------------------------o----------------------------XXXXX----------------XX--------------B---------------o-----------f-
-----------------------------------------------------------X--------B-------------------------------------------------------M------------------------------------B------------------------------------f-
----------------------------------o--------?--------------XX---------M----------------------o-------------------------------------------M-----------------------------------------????-----------BBBB-f-
---------------------------------------------------------XXX----------------------------------------------------X------X----------------------BBB------------T----------------------------------------f-
--------------------------------------------------------XXXX------------????------------------------------------XX--T--XX---T--------------------------------|----------------------T-----------------f-
m------------------------------------------------------XXXXX-----------T-------E---E----------E-----------------XXX-|--XXX--|--------------------------------|------------E--T------|-----E-----------X-
XXXXXXXXXXXXXXXXXXXXXXXXXXXXXXXXXXXXXXXXXXXXXXXXXXXXXXXXXXXXXXXXXXXXXXX|XXXXXXXX-XXXXXXXXXXXXXXXXXXXXXXXXXXXXXXXXXXX|XXXXXXX|XXXXXXXXXXXXXXXXXXXXXXXXXXXXXXXX|XXXXXXXXXXXXXXX|XXXXXX|XXXXX-XXXXXXXXXXXXX
