--------------------------------------------------------------------------------------------------------------------------------------------------------------------------------------------------------
--------------------------------------------------------------------------------------------------------------------------------------------------------------------------------------------------------
--------------------------------------------------------------------------------------------------------------------------------------------------------------------------------------------------------
--------------------------------------------------------------------------------------------------------------------------------------------------------------------------------------------------------
--------------------------o------------------------------------------------------------------------------------------------------------------------------------------B-----------------B----M-----------
-----------------B-------------------------------------------------------------------------------------------------------------------------?------------------------------------------------------------
--------------------------------------------------------------------------------------------------------------------------------------------------------------------------------------------------------
-----------------XXXX--------------------------------------?------------------------------------------------------------------------------------------------------------------------------------------v-
------------------------------------------------------------------------------------------------------------------o-------?????----------------------------------------------------------------B------f-
------------------------------------------------------------------------------------------------------------------------------?--------------------------------------------------------------------o--f-
-------------------------------------------------------------------------------------------------------------------------------------------------o----------------------------------------------------f-
-----T-----------------X-------------------------------------------------------------------------------------------------------------------------------------------------T----------------------------f-
-----|--------o-------XX--------T-----T------------------------------------------------------------------------------------------BB---------------------o----------------|-------------------------T--f-
-----|---------------XXX--------|-----|---------------X------------------------------------------------------------------------------------------------XXXXXX------------|----------------------???|??f-
m----|-----?????E---XXXX------T-|-----|----E---------XX-----?????-E---------------------------------------------------------------------------------------------------E--|E------------------------|--X-
XXXXX|XXXXXXXXXXXXXXXXXXXXXXXX|X|XXXXX|XXXXXXXXXXXXXXXXXXXXXXXXXXXXXXXXXXXXXXXXXXXXXXXX-XXXXXXXXXXXXXXXXXXXXXXXXXXXXXXXXXXXXXXXXXXXXXXXXXXXXXXXXXXXXXXXXXXXXXXXXXX--XXXXX|XXXXXXXXXXXXXXXXXXXXXXXXX|XXXX
