--------------------------------------------------------------------------------------------------------------------------------------------------------------------------------------------------------
--------------------------------------------------------------------------------------------------------------------------------------------------------------------------------------------------------
--------------------------------------------------------------------------------------------------------------------------------------------------------------------------------------------------------
--------------------------------------------------------------------------------------------------------------------------------------------------------------------------------------------------------
---------????---------------B----------------------------------------B----------------------------------------------------------------------------------------------------------------------------------
----XXXXX-----------------------------------------------------------------------------------------------------------------------------------------------------------------------------------------------
----------------------------------------------------------------------------------------------------------XXXXX----------------B--------------------------------o---------------------------------B-----
-----------------------------------------------------------------------------------------------------------------------------------B-----------------------------M------B-----------------------------v-
--------------------------------------o-----------------------------------------------------------B---------------------------------------------------------------------------------------------------f-
----------------------------------------???---------------------------------------------------------------------------------------------o-------------------------------------------------------------f-
--------------?-------------------------------------------------M------------o------------------------------------------------------------------------------------------------------------------------M-
---------------------------------------------------------------------?????-----?---------------B--------------------------------------B----T-----------------------------------------?----T-----------f-
---------------------------------------------------X-------------------------------------------X-----T------------------T------------------|---------------------------------------XXX----|-----------f-
--------------------------------------------------XX-------------------------------------------XX----|------------------|---------------T--|----X----T---------T--------------------------|-----------f-
m--------------X--------------E------------------XXX---------------------E----------E----------XXX--E|-E----------------|----E----------|--|E---XX---|-------T-|-----E--------------------|--------T--X-
XXXXXXXXXXXXXXXXX-XXXXXXXXXXXXXXXXXXXXXXXXXXXXXXXXXXXXXXXXXXXXXXXXXXXXXXXXX-XXXXXXXX--XXXXXXXXXXXXX--|XXXXXXXXXXXXXXXXXX|XXXXXXXX--XXXXX|XX|XXXXXXXXX|XXXXX-X|X|XXXXXXXXXXXXXXXXXXXXXXX-XX|XXXXXXXX|XXXX
