--------------------------------------------------------------------------------------------------------------------------------------------------------------------------------------------------------
--------------------------------------------------------------------------------------------------------------------------------------------------------------------------------------------------------
--------------------------------------------------------------------------------------------------------------------------------------------------------------------------------------------------------
--------------------------------------------------------------------------------------------------------------------------------------------------------------------------------------------------------
--------------------------------------------------------------------------------------------------------------------------------------------------------------------------------------------------------
--------------------------------------------------------------------------------------------------------------------------------------------------------------------o-----------------------------------
--------------------------------------------------------B-----------------------------------------------------------------------------------------------------------------------------------------------
-------------o------------------------------------------------------------------------------------------------------------------------o----XX?--------------------o-----------------------------------v-
------------------------??----------------------------------------------------------------------------------------------------------------------------------------------------------------------------f-
----------------------------------------??-----------------?------------------------------------------------------------------------------------------------------------------------------------------f-
------------------------------------------------------------------------------------------------------------------------------------o-?-----------------------------o---------------------------------f-
--------------------------------------------------------------------------------------------------B-----------------------------------------T---T-----BBBBB-----------------------------------------?-f-
----------------------------------XXXXXX-------T------------------------------BBB-----------------------------------------------------------|---|--------------------------T--------------------------f-
-----------------------------------------------|-------------------------------------------------------------------------------------------T|---|--------T-----------------|--------------------------f-
m---------------E-------------------E----------|--------T---------E--------------------E---E----T---------------E--------------------------||---|-------E|-----------------|--------------------------X-
XXXXXXXXXXXXXXXXXXXXXXXXXXXXXXXXXXXXXXX--XXXXXX|XXXXXXXX|XXXXXXXXXXXXXXXXXXXXXXXXXXXXXXXXXXXXXXX|XXXXXXXXXXXXXX-XXXXXXXXXXXXXXXXX---XXXXXXX||XXX|XXXXXXXX|XXX-XXXXXXXXXXXXX|XXXXXXXXXXXXXXXXX---XXXXXXXX
