--------------------------------------------------------------------------------------------------------------------------------------------------------------------------------------------------------
--------------------------------------------------------------------------------------------------------------------------------------------------------------------------------------------------------
--------------------------------------------------------------------------------------------------------------------------------------------------------------------------------------------------------
--------------------------------------------------------------------------------------------------------------------------------------------------------------------------------------------------------
--------------------------------------------------B----------------------------------------------------B----------------------------------------------------------------B-------------------------------
--------------------------------------------------------------------------------B----------M------------------------------------------------------------------------------------------------------------
-------------------------------------------------------------------------------------------------------------------------------------------------M------------------------------------------------------
------------------------------------------o-------------------------------------------XX-----------------------------------------------------------------------------------------------------------o--v-
-----------------------------------------------------------------------------------------------------BB------------------BBBBBB------------------------------M----------------------------------------f-
--------------------XXXX------------------------------------------------------------------------------------------------------------------------------------------------------------------------------f-
----------X-------???----------------------------------------------------------------------------------------------------------------------------------------------B----------------------------------f-
---------XX-------------------------------XXXXX----------------------o-------------------------M------------------------------X---------------------------------XXX----XX-----------------------???---f-
------T-XXX---------T----------------------------------------------------o---------T--------X----------------------------o----XX----------------------------------------------------------------------f-
------|XXXX---------|--------------------------------------------------------------|---X----XX--------------------------------XXX--------------------------------------------------T------------------f-
m-----|XXXX---------|-----------------------------------T--------T-E---------E-----|--XX----XXX---E--------E------------------XXXX--E----------------E-----XXXX--------------------|------------------X-
XXXXXX|XXXXXXXX-XXXX|XXXXXXXXXXXXXXXXXXXXXXXXXXXXX--XXXX|XXXXXXXX|XXXXXXXXXXXXXXXXX|XXXXXXX-XXXXXXX---XXX---XXXXXXXXXXXXXXXXXXXXXXXXXXXXXXXXXXXXXXXXXXXXXXXXXXXXXXXXXXXXXXXXXXXXXXX|XXXXXXXXXXXXXXXXXXXX
