--------------------------------------------------------------------------------------------------------------------------------------------------------------------------------------------------------
--------------------------------------------------------------------------------------------------------------------------------------------------------------------------------------------------------
--------------------------------------------------------------------------------------------------------------------------------------------------------------------------------------------------------
-----------------------------------BBB---------------------------------------------------??-------------------------------------------------------------------------------------------------------------
-----------------------------M-------------------------------------------------------------------------------M-----------------------------------------------------------------B------------------------
---------------------------------------------------------------------------------M-----------------------------------B--------------------------------------------------------------M--------------B----
-----------------------?????---------------------------------------------------------------------------------------------------------------------------------o----------------------------------?-------
------------------------------------------------------------------------------------------M---------------------------------------------------------o-------------------------------------------------v-
-----------------------------------------------------------------------------o------------------------------------------------------------------------------------------------------B-----------------f-
------------------------------------------------------------------------------------------------------------BBBB-----------------------------?-----------------o--------------------------------------f-
----------------------------------------------------------------------------------------------------------------------------------------------------------------------------o-B----B------------------f-
---------------------------------B----------------------------------------------------B--------o----------------------------------------------T----------o---B---------B------------------------------f-
------------------------------------------X----------------------XXXXXX-----------------BBBBB-------------------------------------------------|X--------------------T-----------------------T---------f-
----------------------X--X----------------XX---------------------------------------------------------------------------------------------BBBB-|XX------T-----T------|-------------------X---|--T------f-
m--------------------XX-XX----------------XXX-------------------------------------------------------------------------------------------------|XXX-----|-----|------|-------------------XX--|--|-----EX-
XXXXXXXXXXXXXXXXXXXXXXXXXXX-XXXXXXXXXXXXXXXXXXXXXXXXXXXXXXXXXXXXXXXXXXXXXXXXXXXXXXXXXXX-XXXXXXXXXXXX--XXXXXXX--XX--XXXXXXXXXXXXXXXXXXXXX--XXXX|XXXXXXXX|XX-XX|XXXXXX|XXXXXXXXX--XXXXXXXXXXXX|XX|XXXX---X
