--------------------------------------------------------------------------------------------------------------------------------------------------------------------------------------------------------
--------------------------------------------------------------------------------------------------------------------------------------------------------------------------------------------------------
--------------------------------------------------------------------------------------------------------------------------------------------------------------------------------------------------------
----------------??---------------------------------------------------------------------------------------------------------------------------XXXX------------BBBBBB-------------------------------------
------o--B------------------------------------------------------------------------------------------------------------XX----M---------------------BXXX---------------------------B----------------------
----o---------------------------------------------------M-------------------------------------BBB------------------------------------------B----------XXX-------------------------------------o---------
-M-----------------------???----------------------------------------------------------------------------------------------------------?-----------------------------------------------o--------B--------
-------------------------------------------------------------------------------------------------?------------------------------------B-----------------------------B---------o-----------------------v-
--------------------------?????--------------------------------------------------------XXX-------------------------------------------------------------------------?-------------------o--------------f-
--------------------------------M-------------------------------------------------------------M-M???--------M------------------------------------------------------B-------------------------o--------f-
---------------------------------B----------------------------------------------------------------------------M--------BB----------------------------------------------???--------o---------B--------Xf-
------------------------------T--------------o------------------------------BBBBB-------B---------------------B---------------------------------------------------------------------BBBB------------XXf-
------------------------------|------------------------------------------------------------------T---------------------XXXXT-----------X-----------------------------------------------------??----XTXf-
------------T-------------T---|------------------------------------------------------------------|-------XXXX--------------|-----------XX---------------------------------------------------BBBB--XX|Xf-
m----T-E----|----------EE-|---|-----------------------------------------------EX-E---E-----------|-------------------EE----|---------E-XXX------------------------------X---T-----E--------------XXX|XX-
XXXXX|XXXXX-|-XXXXXXX-XXXX|XXX|XXXXXXXXXXXXXXXXXXXXXXXXXXXXXXXXXX----X---XXXXX-XXXXXXXXXXXXXXXXXX|--XXXXXXXXXXXXXXXXXXX-X--|XXXX-----XXXXXXXXX??-XXXXXX-XXXXXXXXXXXXXXXXXXXX|XXXXXXXXXXXXXXXXXXXXXXX|XXX
