--------------------------------------------------------------------------------------------------------------------------------------------------------------------------------------------------------
--------------------------------------------------------------------------------------------------------------------------------------------------------------------------------------------------------
--------------------------------------------------------------------------------------------------------------------------------------------------------------------------------------------------------
--------------------------------------------------------------------------------------------------------------------------------------XX----------------------------------------------------------------
-----------------------------------------------------------------------------------B------------------------------------------------------B-----------B------------o------------------------------------
------------------------------------------------------------------------------------------------------------------------------------------------------------?---------XXXXX------------?----------------
------------------------------o--------------------------------------------------------------------------B----------------o------------------------------------B----------------------------?-----------
---------------------------------------------------------------------------------------------------------------------------------------B----------------------------------?------------------------o--v-
----------------------------------------------Xo---------------------------------------------B---------------------?----------------------------------------------------------------?-----------------f-
--B------------------------------------------o---------------------------------------------------------------------------------------------------------B----------------------------------------------f-
-----------------------------------------------------------------------o----------X------------------------------------------------------------M--------------------------------------M---------------f-
----------------T--------------T-----B----------------------T------------------M-XX--BBB-----T-------------------T------------------------------------------------------------BBBBB-----------------T-X-
--------o-------|--------------|----------------------------|---------------X---XXX----------|-------------------|----o-----------------------------------------------------------------X-----------|-X-
----------------|--------------|----------------------BBBTBB|------------BBBXX-XXXX----------|----------T--------|??--------------------------------------------------------------------XX----------|XX-
m----T----------|--E-----------|----------E--E-----------|--|---------------XXXXXXX----------|-??E??----|--------|----------------ET----------E----------------E-------------E-E--------XXX---------|XX-
XXX-X|XXXXXXXXXX|XXXXXXXXXXXXXX|XXXXXXXXXXXXXXXXXXXXXXXXX|XX|XXXXXXXXXXXXXXXXXXXXXXXXXXXXX-XX|XXXXXXXXXX|XXXXXXXX|XXXXXXX-?????XXXX|XXXXXXXXXXXXX---XXXXXXXXXXXXXXXXXXXXXXXXXXXXXXXXXXXXXXXXXXXXXX-X|XXX
