--------------------------------------------------------------------------------------------------------------------------------------------------------------------------------------------------------
--------------------------------------------------------------------------------------------------------------------------------------------------------------------------------------------------------
--------------------------------------------------------------------------------------------------------------------------------------------------------------------------------------------------------
--------------------------------------------------------------------------------------------------------------------------------------------------------------------------------------------------------
-------------------------------------------------------------?-------------------------------------o----------------------------------------------------------------------------------------------------
--------------------------------------------------------------------------------------------------------------------------------------------------------------------------------------------------------
----------------------M--------------------------------------------------------------------------------------------------------------------------------------------o----------------M-------------------
------------------------------------------------------------------------------------------------------------------------------------------------------------------------------------------------------v-
------B------------------------------------------------------------------------------------------------------------o------?---------------------------------------------------------------------------f-
----B-----------------------------------------------------------------------M----------------------------------------------------------------------------------o---o----------------o-----------------f-
-----------------------------------------------------------------------------B-----------------------------------------------------------------------------------------------------o------------------f-
----T----M------------------------------------------------------X----------------------------------------------------o-----?------------------------------------XXX----------------------------------BB-
----|----------------------------------------------------------XX------------------------------------T------------------------------------------------------o-----X-X----------------------T----------f-
----|-----------------T--------T------------------------------XXX------------------------------------|------------------------------------------------------------XXX----------------------|----------f-
m---|--E--------------|--------|-----------------------------XXXX----------------------T-------------|-E--------------------------------BBBBBB--------------------XXX----------------------|----------X-
XXXX|XXXXXXXXXXXXXXXXX|XXXXXXXX|XXXXXXXXXXXXXXXXXXXXXXXXXXXXXXXXXXXXXXXXXXXXXXXXXXXXXXX|XXXXXXXXXXXXX|XXXXXXXXXXXXXXXXXXXXXXXXXXXXXXXXXXXXXXXXXXXXXXXXXXXXXXXXXXXXXXXXXXXXXXXXXXXXXX--XXXXX|XX---XXXXXXX
