--------------------------------------------------------------------------------------------------------------------------------------------------------------------------------------------------------
--------------------------------------------------------------------------------------------------------------------------------------------------------------------------------------------------------
--------------------------------------------------------------------------------------------------------------------------------------------------------------------------------------------------------
---------------------------------------------------------------------------------XXXXX------------------------------------------------------------------------------------------------------------------
------------------------------------------o-?---------o--------------o----------------------------------------------------------------------o---??------------------------------------------------------
------------------------------------------------------BBBBBB---?------------M----------------------------------M--------------------B--------------------------------------??---------o-----------------
---------------------------------B------------B-------B--------------------------------------------------------------------------------------------------------BB--------o------------------------------
----------------------------------------------------o--Bo----------?------------------------------------------------------------------------------------------------------o---------------------------v-
-----------B------------------------------------------------------------------------------BBBBBB-------------------------------------------------------B----------------------------------------------f-
-------------------M-------------M--------------------------------?--B-----------------------------------------B-----M---------------------------------------------------????-----------?????---------f-
----------------------------------------------------------------------------B----------------o-----------------------------------------------------------------------------B--------------------------f-
---------------------------------------------T---------------X--------------------------------------------------------------BBB-------------------------X--T-------------------------------------T----B-
-----------------------------------------T---|--------------XX-----------------------------------------------------------------BBBB--------------------XX--|----------------------XXXXXX---------|----f-
-----------------------------------------|---|-------------XXX------XXXXXT----------------------------------------------------------------------------XXX--|-------------------------BBBB-------X|----f-
m----------------------------------------|---|--------E---XXXX-----------|---------------------------EE---------------E--------------------------E---TXXX--|----------------E--T----------------X|E---X-
XXXXXXXXXXXXXXXXXXXXXXXXXXX-XXXXXXXXXXXXX|XX-|XXXXXXXXXXXXXXXX--XXXXXXXXX|X-XXXXXXXXXXXXXXX-XXXXXXXXXXXXXXXXXXXXX--XXXXXXXXXXXXXXXXXXXXXXXXXXXXXXXXXX|XXXXX|XXXXXXXXXXXXXXXXXXX|-XXXXXX---XXXXXXX|XXXXXX
